111111111111111111111111111
111111111111111111111111111
110P01001000100001000000011
110000000000000001000000011
110000000000000001000000011
110000000010001001110000011
110000100100001101000000111
1100000000C0000001000000011
110000000000000001000000011
110000000000000001000000011
11000000C000000001000000011
111000001000100001000000011
1100000000E0000001000000011
110000000000000001000000011
110000000010011001110000011
11000C100100001101000000111
111111111111111111111111111