11111111111111111111111111111111111111111111
1E0000000000000000000100000000000000000000C1
10000000000000000000000000000000000000000001
100000000000000000000100000000000000000000C1
11111111111111000000000000000011111111111111
1C0000000000000000000100000000000000000000C1
10000000000000000000000000000000000000000001
1C0000000000000000000100000000000000000000C1
11111111111111000000000000000011111111111111
1C0000000000000000000100000000000000000000C1
10000000000000000000000000000000000000000001
1C0000000000000000000100000000000000000000C1
11111111111111000000000000000011111111111111
1C0000000000000000000100000000000000000000C1
100000000000000000000000000000H0000000000001
1C0000000000000000000100000000H00000000000P1
11111111111111111111111111111111111111111111