11111111111111111111111111111111111111111111111111111111111111
1E00000000000000000P010000000000000000000000000000000000000001
10000000000000000000000000000000000000000000000000000000000001
10000000000000000000010000000000000000000000000000000000000001
100000C0000000000000000000000000000000000000000000000000000001
10000000000000000000010000000000000000000000000000000000000001
10000000000000000000000000000000000000000000000000000000000001
10000000000000000000010000000000000000000000000000000000000001
10000000000000000000000000000000000000000000000000000000000001
10000000000000000000010000000000000000000000000000000000000001
10000000000000000000000000000000000000000000000000000000000001
10000000000000000000010000000000000000000000000000000000000001
10000000000000000000000000000000000000000000000000000000000001
10000000000000000000010000000000000000000000000000000000000001
10000000000000000000000000000000000000000000000000000000000001
10000000000000000000010000000000000000000000000000000000000001
11111111111111111111111111111111111111111111111111111111111111